NO ./textures/north.xpm
SO ./textures/brick.xpm
WE ./textures/rock_wall.xpm
EA ./textures/blue_wall.xpm

F 50,50,50
C 135,206,235

        111111111111111
        100000000000001
        100000000000001
        100000100000001
        100000100000001
111111110000010000000111111
100000000000010000000000001
100000000000000000000000001
100001000000000000001000001
100001000000N00000001000001
100001000000000000001000001
100000000000000000000000001
100000000000010000000000001
111111110000010000000111111
        100000100000001
        100000100000001
        100000000000001
        100000000000001
        111111111111111
