NO ./textures/rock_wall.xpm
SO ./textures/blue_wall.xpm
WE ./textures/gray_wall.xpm
EA ./textures/red_wall.xpm

F 202,202,202
C 100,150,200

111111111111111111111111111111
100000000000000000000000000001
100000000000000000000000000001
100000000000000000000000000001
100011110000111100001111000001
100010010000100100001001000001
100010010000100100001001000001
100011110000111100001111000001
100000000000000000000000000001
100000000000000000000000000001
100000011111111111111100000001
100000010000000000000100000001
100000010011100111001N0000001
100000010010000001001000000001
100000010010000001001000000001
100000010011100111001000000001
100000010000000000001000000001
100000011111111111111000000001
100000000000000000000000000001
100000000000000000000000000001
100001100000110000011000000001
100001100000110000011000000001
100000000000000000000000000001
100000000000000000000000000001
100000011001100110011000000001
100000011001100110011000000001
100000000000000000000000000001
100000000000000000000000000001
100000000000000000000000000001
111111111111111111111111111111
