NO ./textures/north.xpm
SO ./textures/south.xpm
WE ./textures/west.xpm
EA ./textures/east.xpm

F 220,100,0
C 225,30,0

11110111 1110101 101111010001
11111111 1111111 111111111111
10000000000000001100000010001
10000000000000001101010010001
11000001110101011111011110N0111
