1111111111111111111111111
1000000000110000000000001
1011000001110000000000001
1001000000000000000000001
111111111011000001110000011111111
100000000011000001110111111111111
11110111111111011100000010001
11110000111111011101010010001
11000000000000000000000010001
10000E00000000001000000000001
10000000000000000001010010001
1100000111010101111101111000111
1111011111111010111101111010001
1111111111111111111111111111111
